Level 4: Citadel
1 2 1 1 3 1 1 2 1
6 1 2 1 4 1 2 1 6
1 1 1 1 5 1 1 1 1
1 5 1 3 4 3 1 5 1
1 1 1 1 6 1 1 1 1
1 1 1 1 4 1 1 1 1